NO ./pics/purplestone.png

SO ./pics/redbrick.png
WE ./pics/mossy.png
EA ./pics/colorstone.png

F 128,83,11

floor color

C 52,210,235

ceiling color
        1111111111111111111111111
        1000000000110000000000001
        1011000001110000000000001
        1001000000000000000000001
111111111011000001110000000000001
100000000011000001110111110111111
11110111111111011100000010001
11110111111111011101010010001
110000001101010111000000000011
10000000000000001100000010001
10000000000000001101010010001
1100000111010101111101111000111
11110111111111011101010010001
110000001101010111000000000011
10000000000000001100000010001
10000000000000001101010010001
1100000111010101111101111000111
11110111111111011101010010001
110000001101010111000000000011
10000000000000001100000010001
10000000000000001101010010001
1100000111010101111101111000111
11110111111111011101010010001
110000001101010111000000000011
10000000000000001100000010001
10000000000000001101010010001
1100000111010101111101111000111
11110111111111011101010010001
110000001101010111000000000011
10000000000000001100000010001
10000000000000001101010010001
1100000111010101111101111000111
11110111111111011101010010001
110000001101010111000000000011
10000000000000001100000010001
10000000000000001101010010001
1100000111010101111101111000111
11110111111111011101010010001
110000001101010111000000000011
10000000000000001100000010001
10000000000000001101010010001
1100000111010101111101111000111
11110111111111011101010010001
110000001101010111000000000011
10000000000000001100000010001
10000000000000001101010010001
1100000111010101111101111000111
11110111111111011101010010001
110000001101010111000000000011
10000000000000001100000010001
10000000000000001101010010001
1100000111010101111101111000111
11110111111111011101010010001
110000001101010111000000000011
10000000000000001100000010001
10000000000000001101010010001
1100000111010101111101111000111
11110111111111011101010010001
110000001101010111000000000011
10000000000000001100000010001
10000000000000001101010010001
1100000111010101111101111000111
11110111111111011101010010001
110000001101010111000000000011
10000000000000001100000010001
10000000000000001101010010001
1100000111010101111101111000111
11110111111111011101010010001
110000001101010111000000000011
10000000000000001100000010001
10000000000000001101010010001
1100000111010101111101111000111
11110111111111011101010010001
110000001101010111000000000011
10000000000000001100000010001
10000000000000001101010010001
1100000111010101111101111000111
11110111111111011101010010001
110000001101010111000000000011
10000000000000001100000010001
10000000000000001101010010001
1100000111010101111101111000111
11110111111111011101010010001
110000001101010111000000000011
10000000000000001100000010001
10000000000000001101010010001
1100000111010101111101111000111
11110111111111011101010010001
110000001101010111000000000011
10000000000000001100000010001
10000000000000001101010010001
1100000111010101111101111000111
11110111111111011101010010001
110000001101010111000000000011
10000000000000001100000010001
10000000000000001101010010001
1100000111010101111101111000111
11110111111111011101010010001
110000001101010111000000000011
10000000000000001100000010001
10000000000000001101010010001
1100000111010101111101111000111
11110111111111011101010010001
110000001101010111000000000011
10000000000000001100000010001
10000000000000001101010010001
1100000111010101111101111000111
11110111111111011101010010001
110000001101010111000000000011
10000000000000001100000010001
10000000000000001101010010001
1100000111010101111101111000111
11110111111111011101010010001
110000001101010111000000000011
10000000000000001100000010001
10000000000000001101010010001
1100000111010101111101111000111
11110111111111011101010010001
110000001101010111000000000011
10000000000000001100000010001
10000000000000001101010010001
1100000111010101111101111000111
11110111111111011101010010001
110000001101010111000000000011
10000000000000001100000010001
10000000000000001101010010001
1100000111010101111101111000111
11110111111111011101010010001
110000001101010111000000000011
10000000000000001100000010001
10000000000000001101010010001
1100000111010101111101111000111
11110111111111011101010010001
110000001101010111000000000011
10000000000000000000000010001
10000000000000001101010010001
1100000111010101111101111000111
11110111 1110101 101111010N01
11111111 1111111 111111111111

barrel.png
bluestone.png

eagle.png
greenlight.png
greystone.png

pillar.png

wood.png
