NO ./pics/purplestone.png
SO ./pics/redbrick.png
WE ./pics/img1.png
EA ./pics/colorstone.png

F 0,255,0
C 0,0,255

        1111111111111111111111111
        1000000000110000000000001
        1011000001110000000000001
        1001000000000000000000001
111111111011000001110000000000001
100000000011000001110111110111111
11110111111111011100000010001
1111011111111101110101001000111
1100000011010101110000001000111
1000000000000000110000001000101
1000000000000000110000001000101
1000000000000000110000001000101
1000000000000000110000001000101
1000000000000000110000001000101
1000000000000000110000001000101
1000000000000000110000001000101
1000000000000000110000001000101
1000000000000000110000001000101
1000000000000000110000001000101
1000000000000000110000001000101
1000000000000000110101001000111
11000001110101011111011110N011
11110111 1110101 1011110100011
11111111 1111111 1111111111111
