NO ./path_to_the_north_texture 
SO ./path_to_the_south_texture
WE ./path_to_the_west_texture
EA ./path_to_the_east_texture

F 220,100,0

floor color

C 225,30,0

ceiling color
        1111111111111111111111111
        1000000000110000000000001
        1011000001110000000000001
        1001000000000000000000001
111111111011000001110000000000001
100000000011000001110111110111111
1111011111111101110000001000111
1111011111111101110101001000111
11000000110101011100000010001111
10000000000000001100000010001111
1000000000000000110101001000111
11000001110101011111011110S0111
11110111 1110101 10111101000111
11111111 1111111 11111111111111